000000000000000000000000000000
000000000002000000000000000000
000000000015000000000000000000
000000000011000110000001100000
000000000011111111111111110000
000000000011111111111111110000
000000000011011111100000000000
000000000011111111111000000000
000000000011111111111000000000
000000000011011111100000000000
000000000011011111100000000000
000000000011111111111110000000
000000000011111111111110000000
000000000011000110000000000000
000000000011111111111111110000
000000000011111111111111110000
000000111111000110000000000000
000000111111000110000000000000
000000000011000110000000000000
000000110011000110000000000000
000111111111111111111110000000
000111111111111111111110000000
000000110011000110000000000000
000000000000011001100000000000
000000000000011001100000000000
000000000000000001100000000000
000000000000000001100000000000
000000000000000000000000000000
000000000000000000000000000000
000000000000000000000000000000
